38 100
+ +-+-+-+-+-+-+-+-+-+-+-+-+-+-+-+-+-+-+-+-+-+-+-+-+-+-+-+-+-+-+-+-+-+-+-+-+-+
|   |   |   |   |   |   |   |   |   |   |   |   |   |   |   |   |   |   | |
+ + + + + + + + + + + + + + + + + + + + + + + + + + + + + + + + + + + + + + +
| | | | | | | | | | | | | | | | | | | | | | | | | | | | | | | | | | | | | | |
+ + + + + + + + + + + + + + + + + + + + + + + + + + + + + + + + + + + + + + +
| | | | | | | | | | | | | | | | | | | | | | | | | | | | | | | | | | | | | | |
+ + + + + + + + + + + + + + + + + + + + + + + + + + + + + + + + + + + + + + +
| | | | | | | | | | | | | | | | | | | | | | | | | | | | | | | | | | | | | | |
+ + + + + + + + + + + + + + + + + + + + + + + + + + + + + + + + + + + + + + +
| | | | | | | | | | | | | | | | | | | | | | | | | | | | | | | | | | | | | | |
+ + + + + + + + + + + + + + + + + + + + + + + + + + + + + + + + + + + + + + +
| | | | | | | | | | | | | | | | | | | | | | | | | | | | | | | | | | | | | | |
+ + + + + + + + + + + + + + + + + + + + + + + + + + + + + + + + + + + + + + +
| | | | | | | | | | | | | | | | | | | | | | | | | | | | | | | | | | | | | | |
+ + + + + + + + + + + + + + + + + + + + + + + + + + + + + + + + + + + + + + +
| | | | | | | | | | | | | | | | | | | | | | | | | | | | | | | | | | | | | | |
+ + + + + + + + + + + + + + + + + + + + + + + + + + + + + + + + + + + + + + +
| | | | | | | | | | | | | | | | | | | | | | | | | | | | | | | | | | | | | | |
+ + + + + + + + + + + + + + + + + + + + + + + + + + + + + + + + + + + + + + +
| | | | | | | | | | | | | | | | | | | | | | | | | | | | | | | | | | | | | | |
+ + + + + + + + + + + + + + + + + + + + + + + + + + + + + + + + + + + + + + +
| | | | | | | | | | | | | | | | | | | | | | | | | | | | | | | | | | | | | | |
+ + + + + + + + + + + + + + + + + + + + + + + + + + + + + + + + + + + + + + +
| | | | | | | | | | | | | | | | | | | | | | | | | | | | | | | | | | | | | | |
+ + + + + + + + + + + + + + + + + + + + + + + + + + + + + + + + + + + + + + +
| | | | | | | | | | | | | | | | | | | | | | | | | | | | | | | | | | | | | | |
+ + + + + + + + + + + + + + + + + + + + + + + + + + + + + + + + + + + + + + +
| | | | | | | | | | | | | | | | | | | | | | | | | | | | | | | | | | | | | | |
+ + + + + + + + + + + + + + + + + + + + + + + + + + + + + + + + + + + + + + +
| | | | | | | | | | | | | | | | | | | | | | | | | | | | | | | | | | | | | | |
+ + + + + + + + + + + + + + + + + + + + + + + + + + + + + + + + + + + + + + +
| | | | | | | | | | | | | | | | | | | | | | | | | | | | | | | | | | | | | | |
+ + + + + + + + + + + + + + + + + + + + + + + + + + + + + + + + + + + + + + +
| | | | | | | | | | | | | | | | | | | | | | | | | | | | | | | | | | | | | | |
+ + + + + + + + + + + + + + + + + + + + + + + + + + + + + + + + + + + + + + +
| | | | | | | | | | | | | | | | | | | | | | | | | | | | | | | | | | | | | | |
+ + + + + + + + + + + + + + + + + + + + + + + + + + + + + + + + + + + + + + +
| | | | | | | | | | | | | | | | | | | | | | | | | | | | | | | | | | | | | | |
+ + + + + + + + + + + + + + + + + + + + + + + + + + + + + + + + + + + + + + +
| | | | | | | | | | | | | | | | | | | | | | | | | | | | | | | | | | | | | | |
+ + + + + + + + + + + + + + + + + + + + + + + + + + + + + + + + + + + + + + +
| | | | | | | | | | | | | | | | | | | | | | | | | | | | | | | | | | | | | | |
+ + + + + + + + + + + + + + + + + + + + + + + + + + + + + + + + + + + + + + +
| | | | | | | | | | | | | | | | | | | | | | | | | | | | | | | | | | | | | | |
+ + + + + + + + + + + + + + + + + + + + + + + + + + + + + + + + + + + + + + +
| | | | | | | | | | | | | | | | | | | | | | | | | | | | | | | | | | | | | | |
+ + + + + + + + + + + + + + + + + + + + + + + + + + + + + + + + + + + + + + +
| | | | | | | | | | | | | | | | | | | | | | | | | | | | | | | | | | | | | | |
+ + + + + + + + + + + + + + + + + + + + + + + + + + + + + + + + + + + + + + +
| | | | | | | | | | | | | | | | | | | | | | | | | | | | | | | | | | | | | | |
+ + + + + + + + + + + + + + + + + + + + + + + + + + + + + + + + + + + + + + +
| | | | | | | | | | | | | | | | | | | | | | | | | | | | | | | | | | | | | | |
+ + + + + + + + + + + + + + + + + + + + + + + + + + + + + + + + + + + + + + +
| | | | | | | | | | | | | | | | | | | | | | | | | | | | | | | | | | | | | | |
+ + + + + + + + + + + + + + + + + + + + + + + + + + + + + + + + + + + + + + +
| | | | | | | | | | | | | | | | | | | | | | | | | | | | | | | | | | | | | | |
+ + + + + + + + + + + + + + + + + + + + + + + + + + + + + + + + + + + + + + +
| | | | | | | | | | | | | | | | | | | | | | | | | | | | | | | | | | | | | | |
+ + + + + + + + + + + + + + + + + + + + + + + + + + + + + + + + + + + + + + +
| | | | | | | | | | | | | | | | | | | | | | | | | | | | | | | | | | | | | | |
+ + + + + + + + + + + + + + + + + + + + + + + + + + + + + + + + + + + + + + +
| | | | | | | | | | | | | | | | | | | | | | | | | | | | | | | | | | | | | | |
+ + + + + + + + + + + + + + + + + + + + + + + + + + + + + + + + + + + + + + +
| | | | | | | | | | | | | | | | | | | | | | | | | | | | | | | | | | | | | | |
+ + + + + + + + + + + + + + + + + + + + + + + + + + + + + + + + + + + + + + +
| | | | | | | | | | | | | | | | | | | | | | | | | | | | | | | | | | | | | | |
+ + + + + + + + + + + + + + + + + + + + + + + + + + + + + + + + + + + + + + +
| | | | | | | | | | | | | | | | | | | | | | | | | | | | | | | | | | | | | | |
+ + + + + + + + + + + + + + + + + + + + + + + + + + + + + + + + + + + + + + +
| | | | | | | | | | | | | | | | | | | | | | | | | | | | | | | | | | | | | | |
+ + + + + + + + + + + + + + + + + + + + + + + + + + + + + + + + + + + + + + +
| | | | | | | | | | | | | | | | | | | | | | | | | | | | | | | | | | | | | | |
+ + + + + + + + + + + + + + + + + + + + + + + + + + + + + + + + + + + + + + +
| | | | | | | | | | | | | | | | | | | | | | | | | | | | | | | | | | | | | | |
+ + + + + + + + + + + + + + + + + + + + + + + + + + + + + + + + + + + + + + +
| | | | | | | | | | | | | | | | | | | | | | | | | | | | | | | | | | | | | | |
+ + + + + + + + + + + + + + + + + + + + + + + + + + + + + + + + + + + + + + +
| | | | | | | | | | | | | | | | | | | | | | | | | | | | | | | | | | | | | | |
+ + + + + + + + + + + + + + + + + + + + + + + + + + + + + + + + + + + + + + +
| | | | | | | | | | | | | | | | | | | | | | | | | | | | | | | | | | | | | | |
+ + + + + + + + + + + + + + + + + + + + + + + + + + + + + + + + + + + + + + +
| | | | | | | | | | | | | | | | | | | | | | | | | | | | | | | | | | | | | | |
+ + + + + + + + + + + + + + + + + + + + + + + + + + + + + + + + + + + + + + +
| | | | | | | | | | | | | | | | | | | | | | | | | | | | | | | | | | | | | | |
+ + + + + + + + + + + + + + + + + + + + + + + + + + + + + + + + + + + + + + +
| | | | | | | | | | | | | | | | | | | | | | | | | | | | | | | | | | | | | | |
+ + + + + + + + + + + + + + + + + + + + + + + + + + + + + + + + + + + + + + +
| | | | | | | | | | | | | | | | | | | | | | | | | | | | | | | | | | | | | | |
+ + + + + + + + + + + + + + + + + + + + + + + + + + + + + + + + + + + + + + +
| | | | | | | | | | | | | | | | | | | | | | | | | | | | | | | | | | | | | | |
+ + + + + + + + + + + + + + + + + + + + + + + + + + + + + + + + + + + + + + +
| | | | | | | | | | | | | | | | | | | | | | | | | | | | | | | | | | | | | | |
+ + + + + + + + + + + + + + + + + + + + + + + + + + + + + + + + + + + + + + +
| | | | | | | | | | | | | | | | | | | | | | | | | | | | | | | | | | | | | | |
+ + + + + + + + + + + + + + + + + + + + + + + + + + + + + + + + + + + + + + +
| | | | | | | | | | | | | | | | | | | | | | | | | | | | | | | | | | | | | | |
+ + + + + + + + + + + + + + + + + + + + + + + + + + + + + + + + + + + + + + +
| | | | | | | | | | | | | | | | | | | | | | | | | | | | | | | | | | | | | | |
+ + + + + + + + + + + + + + + + + + + + + + + + + + + + + + + + + + + + + + +
| | | | | | | | | | | | | | | | | | | | | | | | | | | | | | | | | | | | | | |
+ + + + + + + + + + + + + + + + + + + + + + + + + + + + + + + + + + + + + + +
| | | | | | | | | | | | | | | | | | | | | | | | | | | | | | | | | | | | | | |
+ + + + + + + + + + + + + + + + + + + + + + + + + + + + + + + + + + + + + + +
| | | | | | | | | | | | | | | | | | | | | | | | | | | | | | | | | | | | | | |
+ + + + + + + + + + + + + + + + + + + + + + + + + + + + + + + + + + + + + + +
| | | | | | | | | | | | | | | | | | | | | | | | | | | | | | | | | | | | | | |
+ + + + + + + + + + + + + + + + + + + + + + + + + + + + + + + + + + + + + + +
| | | | | | | | | | | | | | | | | | | | | | | | | | | | | | | | | | | | | | |
+ + + + + + + + + + + + + + + + + + + + + + + + + + + + + + + + + + + + + + +
| | | | | | | | | | | | | | | | | | | | | | | | | | | | | | | | | | | | | | |
+ + + + + + + + + + + + + + + + + + + + + + + + + + + + + + + + + + + + + + +
| | | | | | | | | | | | | | | | | | | | | | | | | | | | | | | | | | | | | | |
+ + + + + + + + + + + + + + + + + + + + + + + + + + + + + + + + + + + + + + +
| | | | | | | | | | | | | | | | | | | | | | | | | | | | | | | | | | | | | | |
+ + + + + + + + + + + + + + + + + + + + + + + + + + + + + + + + + + + + + + +
| | | | | | | | | | | | | | | | | | | | | | | | | | | | | | | | | | | | | | |
+ + + + + + + + + + + + + + + + + + + + + + + + + + + + + + + + + + + + + + +
| | | | | | | | | | | | | | | | | | | | | | | | | | | | | | | | | | | | | | |
+ + + + + + + + + + + + + + + + + + + + + + + + + + + + + + + + + + + + + + +
| | | | | | | | | | | | | | | | | | | | | | | | | | | | | | | | | | | | | | |
+ + + + + + + + + + + + + + + + + + + + + + + + + + + + + + + + + + + + + + +
| | | | | | | | | | | | | | | | | | | | | | | | | | | | | | | | | | | | | | |
+ + + + + + + + + + + + + + + + + + + + + + + + + + + + + + + + + + + + + + +
| | | | | | | | | | | | | | | | | | | | | | | | | | | | | | | | | | | | | | |
+ + + + + + + + + + + + + + + + + + + + + + + + + + + + + + + + + + + + + + +
| | | | | | | | | | | | | | | | | | | | | | | | | | | | | | | | | | | | | | |
+ + + + + + + + + + + + + + + + + + + + + + + + + + + + + + + + + + + + + + +
| | | | | | | | | | | | | | | | | | | | | | | | | | | | | | | | | | | | | | |
+ + + + + + + + + + + + + + + + + + + + + + + + + + + + + + + + + + + + + + +
| | | | | | | | | | | | | | | | | | | | | | | | | | | | | | | | | | | | | | |
+ + + + + + + + + + + + + + + + + + + + + + + + + + + + + + + + + + + + + + +
| | | | | | | | | | | | | | | | | | | | | | | | | | | | | | | | | | | | | | |
+ + + + + + + + + + + + + + + + + + + + + + + + + + + + + + + + + + + + + + +
| | | | | | | | | | | | | | | | | | | | | | | | | | | | | | | | | | | | | | |
+ + + + + + + + + + + + + + + + + + + + + + + + + + + + + + + + + + + + + + +
| | | | | | | | | | | | | | | | | | | | | | | | | | | | | | | | | | | | | | |
+ + + + + + + + + + + + + + + + + + + + + + + + + + + + + + + + + + + + + + +
| | | | | | | | | | | | | | | | | | | | | | | | | | | | | | | | | | | | | | |
+ + + + + + + + + + + + + + + + + + + + + + + + + + + + + + + + + + + + + + +
| | | | | | | | | | | | | | | | | | | | | | | | | | | | | | | | | | | | | | |
+ + + + + + + + + + + + + + + + + + + + + + + + + + + + + + + + + + + + + + +
| | | | | | | | | | | | | | | | | | | | | | | | | | | | | | | | | | | | | | |
+ + + + + + + + + + + + + + + + + + + + + + + + + + + + + + + + + + + + + + +
| | | | | | | | | | | | | | | | | | | | | | | | | | | | | | | | | | | | | | |
+ + + + + + + + + + + + + + + + + + + + + + + + + + + + + + + + + + + + + + +
| | | | | | | | | | | | | | | | | | | | | | | | | | | | | | | | | | | | | | |
+ + + + + + + + + + + + + + + + + + + + + + + + + + + + + + + + + + + + + + +
| | | | | | | | | | | | | | | | | | | | | | | | | | | | | | | | | | | | | | |
+ + + + + + + + + + + + + + + + + + + + + + + + + + + + + + + + + + + + + + +
| | | | | | | | | | | | | | | | | | | | | | | | | | | | | | | | | | | | | | |
+ + + + + + + + + + + + + + + + + + + + + + + + + + + + + + + + + + + + + + +
| | | | | | | | | | | | | | | | | | | | | | | | | | | | | | | | | | | | | | |
+ + + + + + + + + + + + + + + + + + + + + + + + + + + + + + + + + + + + + + +
| | | | | | | | | | | | | | | | | | | | | | | | | | | | | | | | | | | | | | |
+ + + + + + + + + + + + + + + + + + + + + + + + + + + + + + + + + + + + + + +
| | | | | | | | | | | | | | | | | | | | | | | | | | | | | | | | | | | | | | |
+ + + + + + + + + + + + + + + + + + + + + + + + + + + + + + + + + + + + + + +
| | | | | | | | | | | | | | | | | | | | | | | | | | | | | | | | | | | | | | |
+ + + + + + + + + + + + + + + + + + + + + + + + + + + + + + + + + + + + + + +
| | | | | | | | | | | | | | | | | | | | | | | | | | | | | | | | | | | | | | |
+ + + + + + + + + + + + + + + + + + + + + + + + + + + + + + + + + + + + + + +
| | | | | | | | | | | | | | | | | | | | | | | | | | | | | | | | | | | | | | |
+ + + + + + + + + + + + + + + + + + + + + + + + + + + + + + + + + + + + + + +
| | | | | | | | | | | | | | | | | | | | | | | | | | | | | | | | | | | | | | |
+ + + + + + + + + + + + + + + + + + + + + + + + + + + + + + + + + + + + + + +
| | | | | | | | | | | | | | | | | | | | | | | | | | | | | | | | | | | | | | |
+ + + + + + + + + + + + + + + + + + + + + + + + + + + + + + + + + + + + + + +
| | | | | | | | | | | | | | | | | | | | | | | | | | | | | | | | | | | | | | |
+ + + + + + + + + + + + + + + + + + + + + + + + + + + + + + + + + + + + + + +
| | | | | | | | | | | | | | | | | | | | | | | | | | | | | | | | | | | | | | |
+ + + + + + + + + + + + + + + + + + + + + + + + + + + + + + + + + + + + + + +
| | | | | | | | | | | | | | | | | | | | | | | | | | | | | | | | | | | | | | |
+ + + + + + + + + + + + + + + + + + + + + + + + + + + + + + + + + + + + + + +
| | | | | | | | | | | | | | | | | | | | | | | | | | | | | | | | | | | | | | |
+ + + + + + + + + + + + + + + + + + + + + + + + + + + + + + + + + + + + + + +
| | | | | | | | | | | | | | | | | | | | | | | | | | | | | | | | | | | | | | |
+ + + + + + + + + + + + + + + + + + + + + + + + + + + + + + + + + + + + + + +
| | | | | | | | | | | | | | | | | | | | | | | | | | | | | | | | | | | | | | |
+ + + + + + + + + + + + + + + + + + + + + + + + + + + + + + + + + + + + + + +
| | | | | | | | | | | | | | | | | | | | | | | | | | | | | | | | | | | | | | |
+ + + + + + + + + + + + + + + + + + + + + + + + + + + + + + + + + + + + + + +
| | | | | | | | | | | | | | | | | | | | | | | | | | | | | | | | | | | | | | |
+ + + + + + + + + + + + + + + + + + + + + + + + + + + + + + + + + + + + + + +
| | | | | | | | | | | | | | | | | | | | | | | | | | | | | | | | | | | | | | |
+ + + + + + + + + + + + + + + + + + + + + + + + + + + + + + + + + + + + + + +
| | | | | | | | | | | | | | | | | | | | | | | | | | | | | | | | | | | | | | |
+ + + + + + + + + + + + + + + + + + + + + + + + + + + + + + + + + + + + + + +
| | | | | | | | | | | | | | | | | | | | | | | | | | | | | | | | | | | | | | |
+ + + + + + + + + + + + + + + + + + + + + + + + + + + + + + + + + + + + + + +
| | | | | | | | | | | | | | | | | | | | | | | | | | | | | | | | | | | | | | |
+ + + + + + + + + + + + + + + + + + + + + + + + + + + + + + + + + + + + + + +
| | | | | | | | | | | | | | | | | | | | | | | | | | | | | | | | | | | | | | |
+ + + + + + + + + + + + + + + + + + + + + + + + + + + + + + + + + + + + + + +
| | | | | | | | | | | | | | | | | | | | | | | | | | | | | | | | | | | | | | |
+ + + + + + + + + + + + + + + + + + + + + + + + + + + + + + + + + + + + + + +
| | | | | | | | | | | | | | | | | | | | | | | | | | | | | | | | | | | | | | |
+ + + + + + + + + + + + + + + + + + + + + + + + + + + + + + + + + + + + + + +
| | | | | | | | | | | | | | | | | | | | | | | | | | | | | | | | | | | | | | |
+ + + + + + + + + + + + + + + + + + + + + + + + + + + + + + + + + + + + + + +
|   |   |   |   |   |   |   |   |   |   |   |   |   |   |   |   |   |   |   |
+-+-+-+-+-+-+-+-+-+-+-+-+-+-+-+-+-+-+-+-+-+-+-+-+-+-+-+-+-+-+-+-+-+-+-+-+-+-+
